1111111111
1C00010001
10P0G1C001
100001C001
1000CC0CC1
10011G1001
1C0011C001
1C0PPPG001
1E0CCCCG01
1111111111